2 9 19 20 25 30 40 41 42 55 56
9 20 25 35 45 47 55 68 78
5 16 26 33 56 80 85 92 
13 18 19 25 30 31 32 33 45 55 60
8 12 15 18 20 22 24 26 34 40 56 72 80
3 5 10 20 25 33 44 55 66