5 10 12 20 25 30 40 41 42 55 56
8 21 25 35 45 47 55 68 78
11 18 24 33 56 80 85 92 
5 11 13 19 25 30 31 32 33 45 55 60
10 12 19 18 20 22 24 26 34 40 56 72 80
9 5 11 20 25 33 44 55 66